20
20
1 1 1 1 1 1 1 1 1 1 1 1 1 1 1 1 1 1 1 1 
1 0 0 0 0 0 0 0 0 0 0 0 0 0 0 0 0 0 0 1 
1 0 0 0 0 0 0 0 0 0 0 0 0 0 0 0 0 0 0 1
1 2 3 3 4 0 0 0 0 0 0 0 0 0 0 0 0 0 0 1
1 0 1 0 0 0 0 0 0 0 0 0 0 0 0 0 0 0 0 1
1 0 1 0 0 0 0 1 1 1 0 0 7 0 0 0 0 0 0 1 
1 1 1 0 0 0 2 3 3 3 3 3 3 3 3 4 0 0 0 1 
1 0 0 0 0 0 0 0 0 0 0 0 0 0 0 0 0 0 0 1
1 0 0 0 0 0 0 0 0 0 0 0 0 0 0 0 0 0 0 1 
1 0 0 0 0 0 0 0 0 0 0 0 8 0 0 0 2 3 3 1 
1 2 3 3 3 4 0 0 0 0 2 3 3 4 0 0 0 0 0 1
1 0 0 0 0 0 0 0 0 0 0 0 0 0 0 0 0 0 0 1
1 0 0 0 0 0 0 0 0 0 6 0 0 0 0 2 3 4 0 1 
1 0 0 0 0 0 2 3 3 3 3 4 0 0 0 0 1 0 0 1
1 0 0 0 0 0 0 0 0 0 0 0 0 0 0 0 1 1 1 1
1 0 0 0 0 0 0 0 0 0 0 0 0 0 0 0 0 0 0 1
1 0 2 3 3 3 4 0 0 0 0 0 0 0 1 1 1 1 1 1 
1 0 0 0 1 0 0 0 0 0 0 0 0 1 1 1 1 1 1 1
1 0 0 0 1 0 0 0 0 5 0 0 1 1 1 1 1 1 1 1
1 1 1 1 1 1 1 1 1 1 1 1 1 1 1 1 1 1 1 1 